abstract	【形容詞】	抽象的な
accessibility	【名詞】	アクセシビリティー
accessible	【形容詞】	アクセス可能な、利用可能な
activate	【動詞】	有効にする、アクティブにする
active	【形容詞】	有効な、アクティブな
additional	【形容詞】	追加の
adjust	【動詞】	調整する
administrator	【名詞】	管理者
aggregate	【動詞】	集約する
alias	【名詞】	エイリアス、別名
allocation	【名詞】	割り当て
annotation	【名詞】	アノテーション、注釈
anonymous	【形容詞】	無名の、匿名の
append	【動詞】	追加する
applicable	【形容詞】	該当する、適用可能な
archive	【名詞／動詞】	アーカイブ／アーカイブする
assert	【動詞】	アサートする、表明する
asset	【名詞】	アセット、資産
assign	【動詞】	割り当てる
assignment	【名詞】	割り当て
associate	【動詞】	関連づける
attach	【動詞】	接続する、添付する
authentication	【名詞】	認証
authorize	【動詞】	権限を与える
auto	【形容詞】	自動の
automatic	【形容詞】	自動の
automatically	【副詞】	自動で、自動的に
availability	【名詞】	可用性
batch	【名詞】	バッチ
binary	【形容詞】	バイナリーの、二進法の
bind	【動詞】	バインドする
boot	【動詞／名詞】	起動する／起動
brace	【名詞】	波かっこ
bracket	【名詞】	角かっこ
breakpoint	【名詞】	ブレークポイント
browse	【動詞】	閲覧する、参照する
buffer	【名詞／動詞】	バッファー／バッファー処理する
bump	【動詞】	バージョンを上げる
bundle	【名詞／動詞】	バンドル／バンドルする
calculate	【動詞】	計算する
callback	【名詞】	コールバック
capability	【名詞】	機能
capture	【動詞】	取り込む、キャプチャーする
caret	【名詞】	文字入力カーソル、カレット
cast	【動詞】	キャストする
certificate	【名詞】	証明書
checkout	【名詞】	チェックアウト
clarify	【動詞】	明確にする
cleanup	【名詞】	クリーンアップ、整理
clone	【動詞】	複製する
collapse	【動詞】	折りたたむ、非表示にする
compatibility	【名詞】	互換性
compile	【動詞】	コンパイルする
completion	【名詞】	補完、完了
compress	【動詞】	圧縮する
compute	【動詞】	計算する
conditional	【形容詞】	条件つきの
configure	【動詞】	構成する、設定する
confirm	【動詞】	確定する、確認する
conflict	【動詞／名詞】	競合する／競合
constraint	【名詞】	制約
construct	【動詞】	（コンストラクターで）生成する
contact	【動詞／名詞】	連絡する／連絡先
contribute	【動詞】	貢献する
convert	【動詞】	変換する
coordinate	【名詞】	座標
copyright	【名詞】	著作権
crash	【動詞】	クラッシュする、突然停止する
credential	【名詞】	資格情報
debugger	【名詞】	デバッガー
decimal	【形容詞】	小数の、十進法の
declaration	【名詞】	宣言
declare	【動詞】	宣言する
decode	【動詞】	デコードする
dedicated	【形容詞】	専用の
delay	【名詞】	遅延
dependency	【名詞】	依存関係
deploy	【動詞】	配備する、デプロイする
deployment	【名詞】	配備、デプロイ
deprecated	【形容詞】	非推奨の
deprecation	【名詞】	非推奨
descriptor	【名詞】	記述子
destination	【名詞】	目的地、〜先（移動先など）
detect	【動詞】	検出する
digit	【名詞】	数字、桁
disable	【動詞】	無効にする
display	【動詞／名詞】	表示する／表示、画面
distribute	【動詞】	分散する
dump	【動詞】	ダンプする
duplicate	【形容詞／動詞】	重複する／複製する
duration	【名詞】	期間
dynamic	【形容詞】	動的な
dynamically	【副詞】	動的に
emit	【動詞】	発する、生成する
enable	【動詞】	可能にする、有効にする
encode	【動詞】	エンコードする
encoding	【名詞】	エンコーディング、符号化
encounter	【動詞】	遭遇する
encryption	【名詞】	暗号化
endpoint	【名詞】	エンドポイント、端点
ensure	【動詞】	確実にする、確かめる
entity	【名詞】	エンティティー、実体
enumeration	【名詞】	列挙
escape	【動詞】	エスケープする
exclude	【動詞】	除外する
executable	【形容詞／名詞】	実行可能な／実行可能ファイル
execute	【動詞】	実行する
execution	【名詞】	実行
existing	【形容詞】	既存の
extend	【動詞】	拡張する
extension	【名詞】	拡張、拡張子
external	【形容詞】	外部の
extract	【動詞】	抽出する
failure	【名詞】	失敗、故障
fallback	【名詞】	フォールバック
fetch	【動詞】	取得する、フェッチする
framework	【名詞】	フレームワーク
functionality	【名詞】	機能
generation	【名詞】	生成
generic	【形容詞】	汎用の、ジェネリックの
hack	【名詞／動詞】	ハッキング、一時回避策／ハックする、（その場しのぎで）作る
handle	【動詞／名詞】	処理する／ハンドル
handler	【名詞】	ハンドラー
handling	【名詞】	処理
hash	【名詞】	ハッシュ、ハッシュ記号
header	【名詞】	ヘッダー
hierarchy	【名詞】	階層
identifier	【名詞】	識別子
implement	【動詞】	実装する
implementation	【名詞】	実装
incompatible	【形容詞】	互換性がない
increment	【名詞／動詞】	増分、インクリメント／増分させる
indentation	【名詞】	インデント
initial	【形容詞】	初期の、最初の
initialization	【名詞】	初期化
initialize	【動詞】	初期化する
inline	【形容詞／動詞】	インラインの／インライン化する
inner	【形容詞】	内部の、内側の
insert	【動詞】	挿入する
inspect	【動詞】	検査する
inspection	【名詞】	検査
installation	【名詞】	インストール
interact	【動詞】	対話する
internal	【形容詞】	内部の
interval	【名詞】	間隔
invalid	【形容詞】	無効な
invoke	【動詞】	呼び出す
iterate	【動詞】	反復する、繰り返す
latency	【名詞】	待ち時間
launch	【動詞】	起動する、開始する
listener	【名詞】	リスナー
load	【動詞】	読み込む
locale	【名詞】	ロケール
logic	【名詞】	ロジック、論理
lookup	【名詞】	検索、探索、ルックアップ
manual	【形容詞／名詞】	手動の／マニュアル
manually	【副詞】	手動で
map	【名詞／動詞】	地図／対応づける、マッピングする
master	【名詞】	マスター
matching	【形容詞】	一致する、マッチする
maximum	【形容詞】	最大の
metadata	【名詞】	メタデータ
migration	【名詞】	移行
millisecond	【名詞】	ミリ秒
minimum	【形容詞】	最小の
minor	【形容詞】	マイナーな、小さな
mock	【形容詞】	モックの、模造の
modification	【名詞】	修正、変更
modifier	【名詞】	修飾子
modify	【動詞】	修正する、変更する
monitor	【動詞】	監視する
multiple	【形容詞】	複数の
namespace	【名詞】	名前空間
native	【形容詞】	ネイティブの
navigate	【動詞】	移動する
navigation	【名詞】	ナビゲーション、移動
nested	【形容詞】	入れ子の、ネストされた
normalize	【動詞】	標準化する、正規化する
notification	【名詞】	通知
notify	【動詞】	通知する
numeric	【形容詞】	数値の
obtain	【動詞】	取得する
occurrence	【名詞】	出現、発生
offset	【名詞】	オフセット
optimize	【動詞】	最適化する
otherwise	【副詞】	さもないと
overview	【名詞】	概要
overwrite	【動詞】	上書きする
padding	【名詞】	パディング
parenthesis	【名詞】	丸かっこ
parse	【動詞】	パースする、解析する
payload	【名詞】	ペイロード
permit	【動詞】	許可する
persistence	【名詞】	永続化
placeholder	【名詞】	プレースホルダー
plugin	【名詞】	プラグイン
populate	【動詞】	自動入力する
preference	【名詞】	プリファレンス、ユーザー設定
preferred	【形容詞】	優先の
prefix	【名詞】	接頭辞、プレフィックス
priority	【名詞】	優先順位
private	【形容詞】	プライベートな、非公開の
progress	【名詞】	進行状況
protocol	【名詞】	プロトコル
prototype	【名詞】	プロトタイプ
provider	【名詞】	プロバイダー
provision	【名詞】	プロビジョニング
proxy	【名詞】	プロキシ
queue	【名詞】	キュー、待ち行列
raw	【形容詞】	生の
redirect	【動詞】	リダイレクトする、転送する
redundant	【形容詞】	冗長な
refresh	【動詞】	更新する
register	【動詞】	登録する
registration	【名詞】	登録
registry	【名詞】	レジストリー
reload	【動詞】	再読み込みする、リロードする
remote	【形容詞】	遠隔の、リモートの
removal	【名詞】	削除、除去
render	【動詞】	描画する、レンダリングする
repository	【名詞】	リポジトリー
represent	【動詞】	表す
representation	【名詞】	表現
reserve	【動詞】	予約する、確保する
resize	【動詞】	サイズ変更する
resolution	【名詞】	解像度、精度、解決
resolve	【動詞】	解決する
restore	【動詞】	復元する
restriction	【名詞】	制限
retrieve	【動詞】	取得する
revert	【動詞】	（以前の状態に）戻す
revision	【名詞】	改訂、リビジョン
runtime	【名詞】	実行時、ランタイム
sanitize	【動詞】	サニタイズする
scale	【動詞】	（大きさを）変える
schema	【名詞】	スキーマ
scope	【名詞】	スコープ、範囲
secure	【形容詞】	セキュアな、安全な
separator	【名詞】	セパレーター、区切り
sequence	【名詞】	シーケンス
serialize	【動詞】	シリアル化する
session	【名詞】	セッション
setup	【名詞】	設定、構成、セットアップ
shutdown	【名詞】	シャットダウン
signature	【名詞】	署名
simplify	【動詞】	簡素化する
snapshot	【名詞】	スナップショット
socket	【名詞】	ソケット
specification	【名詞】	仕様
split	【動詞】	分割する
stack	【名詞】	スタック
standalone	【形容詞】	スタンドアロンの
startup	【名詞】	起動、スタートアップ
static	【形容詞】	静的な
storage	【名詞】	ストレージ
stream	【名詞】	ストリーム
successfully	【副詞】	正常に
suffix	【名詞】	接尾辞、サフィックス
suppress	【動詞】	表示しない
synchronize	【動詞】	同期する
syntax	【名詞】	構文、シンタックス
terminate	【動詞】	終了する
termination	【名詞】	終了
terms	【名詞】	利用条件
third party	【名詞】	サード・パーティー、第三者
thread	【名詞】	スレッド
timestamp	【名詞】	タイムスタンプ
todo	【名詞】	TODO、するべきこと
toggle	【動詞】	切り替える
token	【名詞】	トークン
transaction	【名詞】	トランザクション
transfer	【動詞】	転送する
transform	【動詞】	変換する、変形する
transition	【名詞】	遷移
trigger	【動詞】	トリガーする
tweak	【動詞】	微調整する
typo	【名詞】	入力ミス、タイポ
unauthorized	【形容詞】	権限のない
unavailable	【形容詞】	利用できない
undefined	【形容詞】	未定義の
unexpected	【形容詞】	予期しない
unique	【形容詞】	一意の、固有の
unknown	【形容詞】	不明の
unnecessary	【形容詞】	不要な
unresolved	【形容詞】	未解決の
unsupported	【形容詞】	非対応の、サポートされない
usage	【名詞】	利用、使用
username	【名詞】	ユーザー名
valid	【形容詞】	有効な
validate	【動詞】	検証する
validation	【動詞】	（妥当性を）確認する、検証する
verbose	【形容詞】	詳細な
verify	【動詞】	（正しいことを）確認する、認証する
virtual	【形容詞】	仮想の
visibility	【名詞】	可視性、可視範囲
visible	【形容詞】	表示できる
whitespace	【名詞】	空白、スペース
wrap	【動詞】	ラップする、（テキストを）折り返す
wrapper	【名詞】	ラッパー
zip	【動詞】	（ファイルを）圧縮する