action	【名詞】	アクション、操作
activity	【名詞】	アクティビティー、活動
add	【動詞】	追加する
address	【名詞】	アドレス、住所
agree	【動詞】	同意する
area	【名詞】	領域、エリア
below	【副詞】	下記に
body	【名詞】	本体、本文
break	【動詞】	中断する
build	【動詞／名詞】	構築する／ビルド
button	【名詞】	ボタン
call	【動詞】	呼び出す
change	【動詞】	変更する
check	【動詞】	確認する、チェックする
child	【名詞】	子
choose	【動詞】	選択する
class	【名詞】	クラス
clean	【形容詞／動詞】	きれいな／きれいにする
close	【動詞】	閉じる
compare	【動詞】	比較する
complete	【動詞／形容詞】	完了する／完全な
copy	【動詞／名詞】	コピーする／コピー
correct	【形容詞／動詞】	正確な／訂正する
create	【動詞】	作成する
describe	【動詞】	説明する
description	【名詞】	説明
detail	【名詞】	詳細
email	【名詞／動詞】	メール／メールを送る
event	【名詞】	イベント、出来事
example	【名詞】	例
extra	【形容詞】	余分な、追加の
false	【形容詞】	誤りの、偽の
final	【形容詞】	最終の
find	【動詞】	検索する
finish	【動詞】	終了する、完了する
follow	【動詞】	従う、フォローする
form	【名詞】	フォーム
free	【形容詞】	空きの、無料の
get	【動詞】	獲得する
group	【名詞】	グループ
health	【名詞】	ヘルス、正常性
improve	【動詞】	改良する
include	【動詞】	含む、インクルードする
information	【名詞】	情報
introduce	【動詞】	導入する、紹介する
join	【動詞】	結合する
key	【名詞】	キー
language	【名詞】	言語
later	【副詞】	あとで
line	【名詞】	行、線
list	【名詞／動詞】	リスト／一覧表示する
make	【動詞】	作成する
match	【動詞】	一致する
menu	【名詞】	メニュー
message	【名詞】	メッセージ
model	【名詞】	モデル、型
move	【動詞】	移動する
name	【名詞】	名前
next	【形容詞】	次の
number	【名詞】	数
object	【名詞】	オブジェクト、物体、対象
open	【動詞／形容詞】	開く／開いた
parent	【名詞】	親
password	【名詞】	パスワード
play	【動詞】	再生する
post	【動詞／名詞】	書き込む／投稿
prepare	【動詞】	準備する
problem	【名詞】	問題
product	【名詞】	製品、プロダクト
read	【動詞】	読み取る
return	【動詞】	戻す、返す
rule	【名詞】	ルール、規則
run	【動詞】	実行する
section	【名詞】	セクション、部分
see	【動詞】	見る
send	【動詞】	送信する
service	【名詞】	サービス
set	【動詞】	設定する
show	【動詞】	表示する
size	【名詞】	大きさ
software	【名詞】	ソフトウェア
space	【名詞】	スペース、空白
start	【動詞】	開始する
statement	【名詞】	ステートメント、文
stop	【動詞】	停止する
style	【名詞】	スタイル
test	【名詞／動詞】	テスト／テストする
traffic	【名詞】	トラフィック、通信量
tree	【名詞】	木、ツリー
true	【形容詞】	正しい、真の
use	【動詞／名詞】	使う／使用
useful	【形容詞】	便利な
user	【名詞】	ユーザー
visit	【動詞】	訪問する、アクセスする
wait	【動詞】	待機する
website	【名詞】	ウェブサイト
window	【名詞】	ウィンドウ
write	【動詞】	書き込む
you	【代名詞】	あなた、ユーザー
your	【代名詞】	あなたの、ユーザーの