accept	【動詞】	受諾する
access	【動詞／名詞】	アクセスする／アクセス
account	【名詞】	アカウント、口座
algorithm	【名詞】	アルゴリズム
allow	【動詞】	可能にする、許可する
alternative	【形容詞】	代替の
application	【名詞】	アプリケーション
apply	【動詞】	適用する
argument	【名詞】	引数
array	【名詞】	配列
attribute	【名詞】	属性
audio	【名詞】	オーディオ、音声
author	【名詞】	作成者
available	【形容詞】	利用可能な、入手可能な
avoid	【動詞】	回避する
backup	【名詞】	バックアップ
base	【形容詞／動詞】	ベースの、基底の／〜に基づく（based onで）
bit	【名詞】	ビット
blank	【形容詞】	空白の
block	【名詞／動詞】	ブロック／ブロックする
boolean	【形容詞】	ブール値の
branch	【名詞】	ブランチ、分岐
browser	【名詞】	ブラウザー
bug	【名詞】	バグ
byte	【名詞】	バイト
cache	【名詞】	キャッシュ
cancel	【動詞】	キャンセルする、取り消す
capacity	【名詞】	容量
case	【名詞】	場合、ケース
character	【名詞】	文字
checkbox	【名詞】	チェックボックス
choice	【名詞】	選択
clear	【動詞】	消去する
click	【動詞】	クリックする
client	【名詞】	クライアント
clipboard	【名詞】	クリップボード
cloud	【名詞】	クラウド
cluster	【名詞】	クラスター
code	【名詞】	コード
collection	【名詞】	コレクション、収集
column	【名詞】	列、カラム
command	【名詞】	コマンド、命令
comment	【名詞】	コメント
commit	【動詞】	コミットする、（処理などを）確定する
communication	【名詞】	通信、コミュニケーション
component	【名詞】	コンポーネント、部品
condition	【名詞】	条件
configuration	【名詞】	構成
connect	【動詞】	接続する
connection	【名詞】	接続
console	【名詞】	コンソール
constant	【名詞／形容詞】	定数／一定の
constructor	【名詞】	コンストラクター
contain	【動詞】	含む
container	【名詞】	コンテナー
content	【名詞】	内容、コンテンツ
context	【名詞】	コンテキスト、文脈
continue	【動詞】	続行する
control	【名詞／動詞】	制御、コントロール／制御する
cookie	【名詞】	クッキー
core	【名詞／形容詞】	コア／最重要の
correctly	【副詞】	正しく、正常に
count	【動詞／名詞】	数える／回数、数
current	【形容詞】	現在の
cursor	【名詞】	カーソル
custom	【形容詞】	カスタムの、ユーザー設定の
customize	【動詞】	カスタマイズする
damage	【名詞】	損害、ダメージ
dashboard	【名詞】	ダッシュボード
data	【名詞】	データ
database	【名詞】	データベース
debug	【動詞／名詞】	デバッグする／デバッグ
default	【名詞／動詞】	デフォルト値、既定値／デフォルトで〜になる
define	【動詞】	定義する
delete	【動詞】	削除する
destroy	【動詞】	破棄する
determine	【動詞】	判別する、決定する
developer	【名詞】	開発者
development	【名詞】	開発
device	【名詞】	機器、デバイス
dialog	【名詞】	ダイアログ
directory	【名詞】	ディレクトリー
disk	【名詞】	ディスク
document	【名詞／動詞】	ドキュメント、文書／（文書で）記録する
documentation	【名詞】	ドキュメント、資料
domain	【名詞】	ドメイン
download	【動詞】	ダウンロードする
driver	【名詞】	ドライバー
drop-down	【形容詞】	ドロップダウンの
edit	【動詞】	編集する
editor	【名詞】	エディター
element	【名詞】	要素
empty	【形容詞】	空の
enter	【動詞】	入力する
entry	【名詞】	エントリー、入力
environment	【名詞】	環境
equal	【形容詞／動詞】	等しい／〜に等しい
error	【名詞】	エラー
except	【前置詞】	〜を除く
exception	【名詞】	例外
exist	【動詞】	存在する
exit	【動詞】	終了する
expand	【動詞】	拡大する、展開する
expected	【形容詞】	期待された
export	【名詞／動詞】	エクスポート／エクスポートする
express	【動詞】	表現する
expression	【名詞】	表現、式
fail	【動詞】	失敗する
feature	【名詞】	機能、特徴
field	【名詞】	フィールド
file	【名詞】	ファイル
filter	【名詞／動詞】	フィルター／絞り込む
fix	【動詞】	修正する、解決する
flag	【名詞】	フラグ
folder	【名詞】	フォルダー
following	【形容詞／名詞】	次に述べる／次の項目
font	【名詞】	フォント
force	【動詞】	強制する
format	【名詞／動詞】	フォーマット、書式／初期化する
function	【名詞】	機能、関数
general	【形容詞】	全般の、一般の
generate	【動詞】	生成する
global	【形容詞】	グローバルな、大域の
graphic	【名詞】	グラフィック、画像
guide	【名詞】	ガイド
hardware	【名詞】	ハードウェア
height	【名詞】	高さ
hide	【動詞】	隠す、非表示にする
highlight	【名詞／動詞】	ハイライト／強調表示する
host	【名詞】	ホスト
icon	【名詞】	アイコン
ignore	【動詞】	無視する
image	【名詞】	画像、イメージ
import	【名詞／動詞】	インポート／インポートする
including	【前置詞】	〜を含めて
index	【名詞】	インデックス、索引
indicate	【動詞】	示す
input	【名詞／動詞】	入力／入力する
install	【動詞】	インストールする
installer	【名詞】	インストーラー
instance	【名詞】	インスタンス、実例
instruction	【名詞】	指示
integer	【名詞】	整数
interface	【名詞】	インターフェイス
issue	【名詞】	問題点
item	【名詞】	項目
label	【名詞／動詞】	ラベル／ラベルを貼る
latest	【形容詞】	最近の
layer	【名詞】	レイヤー、層
layout	【名詞】	レイアウト
length	【名詞】	長さ
level	【名詞】	レベル、水準
library	【名詞】	ライブラリー
license	【名詞／動詞】	ライセンス／ライセンス供与する
limit	【動詞／名詞】	制限する／制限
link	【名詞／動詞】	リンク／リンクする
local	【形容詞】	ローカルの、局所の
location	【名詞】	位置、場所
lock	【動詞】	ロックする
log	【名詞／動詞】	ログ／ログを取る
login	【名詞】	ログイン
loop	【名詞】	ループ
manage	【動詞】	管理する
manager	【名詞】	マネージャー
media	【名詞】	メディア
memory	【名詞】	メモリー
merge	【動詞】	マージする、統合する
method	【名詞】	メソッド、方法
missing	【形容詞】	見つからない、欠落している
mode	【名詞】	モード
module	【名詞】	モジュール
network	【名詞】	ネットワーク
node	【名詞】	ノード
none	【代名詞】	一つもなし
normal	【形容詞】	標準の
note	【名詞／動詞】	注意／〜に注意する
notice	【名詞】	通知、注意
null	【形容詞】	空の、nullの
occur	【動詞】	発生する
operation	【名詞】	操作、処理
option	【名詞】	オプション
optional	【形容詞】	任意の、オプションの
output	【名詞／動詞】	出力／出力する
override	【動詞】	オーバーライドする、優先する
owner	【名詞】	所有者、オーナー
package	【名詞】	パッケージ
pane	【名詞】	ペイン、ウィンドウ
parameter	【名詞】	パラメーター、仮引数
pass	【動詞】	渡す
patch	【名詞】	パッチ、修正プログラム
path	【名詞】	パス
perform	【動詞】	実行する
performance	【名詞】	性能、パフォーマンス
permission	【名詞】	許可
physical	【形容詞】	物理的な
pool	【名詞】	プール
popup	【名詞】	ポップアップ
port	【名詞】	ポート
position	【名詞】	位置
press	【動詞】	押す
preview	【名詞／動詞】	プレビュー／プレビューする
previous	【形容詞】	前の
print	【動詞】	印刷する
process	【名詞／動詞】	プロセス／処理する
profile	【名詞】	プロファイル、プロフィール
properly	【副詞】	適切に、正常に
property	【名詞】	プロパティー
protect	【動詞】	保護する
provide	【動詞】	提供する
public	【形容詞】	公開の
publish	【動詞】	公開する
pull	【動詞／名詞】	プルする、取得する／プル
push	【動詞】	押す、プッシュする
query	【名詞】	クエリー
range	【名詞】	範囲
real-time	【形容詞】	リアルタイムの
receive	【動詞】	受信する
recommend	【動詞】	推奨する
record	【動詞／名詞】	記録する／記録、レコード
refactor	【動詞】	リファクターする
refer	【動詞】	参照する
reference	【名詞／動詞】	参照、リファレンス／参照する
release	【動詞】	リリースする、公開する
remove	【動詞】	削除する
rename	【動詞】	名前を変更する
replace	【動詞】	置換する
report	【動詞／名詞】	報告する／レポート
request	【名詞／動詞】	要求、リクエスト／要求する
require	【動詞】	必要とする
reset	【動詞】	リセットする
resource	【名詞】	リソース、資源
respond	【動詞】	応答する、返信する
response	【名詞】	応答
restart	【動詞】	再起動する
result	【名詞】	結果
right-click	【動詞】	右クリックする
role	【名詞】	役割、ロール
root	【名詞】	ルート
route	【名詞】	経路、ルート
row	【名詞】	行
save	【動詞】	保存する
scan	【動詞】	スキャンする、走査する
schedule	【名詞／動詞】	予定、スケジュール／予定する
screen	【名詞】	画面
script	【名詞】	スクリプト
scroll	【動詞】	スクロールする
search	【動詞／名詞】	検索する／検索
security	【名詞】	セキュリティー
select	【動詞】	選択する
server	【名詞】	サーバー
setting	【名詞】	設定
shape	【名詞】	形状
share	【動詞】	共有する
shortcut	【名詞】	ショートカット
sign	【名詞／動詞】	署名／サインイン（sign in）する、サインアウト（sign out）する
skip	【動詞】	スキップする、後でする
sort	【動詞】	並び替える、ソートする
source	【名詞】	ソース、〜元（送信元など）
specific	【形容詞】	特定の
specify	【動詞】	指定する
state	【名詞】	状態
status	【名詞】	状態、ステータス
step	【名詞】	ステップ、手順
store	【動詞】	保存する、格納する
string	【名詞】	文字列
submit	【動詞】	提出する、送信する
successful	【形容詞】	成功した
supply	【動詞】	供給する
support	【動詞／名詞】	サポートする、支援する／サポート
switch	【動詞／名詞】	切り替える／スイッチ
system	【名詞】	システム
tab	【名詞】	タブ
table	【名詞】	表、テーブル
tag	【名詞】	タグ
target	【名詞】	ターゲット、対象、〜先（移動先など）
task	【名詞】	タスク
template	【名詞】	テンプレート
temporary	【形容詞】	一時的な
throw	【動詞】	スローする、投げる
timeout	【名詞】	タイムアウト
touch	【動詞】	タッチする
translate	【動詞】	変換する、翻訳する
type	【名詞／動詞】	種類／（キーボードで）入力する
unable	【形容詞】	不可能な
undo	【動詞】	元に戻す
uninstall	【動詞】	アンインストールする
unit	【名詞】	単位、ユニット
unused	【形容詞】	未使用の
update	【動詞／名詞】	更新する／更新
upgrade	【動詞】	アップグレードする
upload	【動詞／名詞】	アップロードする／アップロード
value	【名詞】	値
variable	【名詞】	変数
version	【名詞】	バージョン、版
view	【動詞／名詞】	表示する／表示、ビュー
warn	【動詞】	警告する
warning	【名詞】	警告
widget	【名詞】	ウィジェット
width	【名詞】	幅
wizard	【名詞】	ウィザード